# h	- Header
# o	- Omit from toc
# r	- top level READMEs to be copied/symlinked
# a	- for auxiliary documentation
# number - indent by
# D	- this version's perldelta
# d	- copied to this name

h Overview

  perl			Perl overview (this section)
  perlintro		Perl introduction for beginners
  perltoc		Perl documentation table of contents

h Tutorials

  perlreftut		Perl references short introduction
  perldsc		Perl data structures intro
  perllol		Perl data structures: arrays of arrays

  perlrequick		Perl regular expressions quick start
  perlretut		Perl regular expressions tutorial

  perlboot		Perl OO tutorial for beginners
  perltoot		Perl OO tutorial, part 1
  perltooc		Perl OO tutorial, part 2
  perlbot		Perl OO tricks and examples

  perlstyle		Perl style guide

  perlcheat		Perl cheat sheet
  perltrap		Perl traps for the unwary
  perldebtut		Perl debugging tutorial

  perlfaq		Perl frequently asked questions
2 perlfaq1		General Questions About Perl
2 perlfaq2		Obtaining and Learning about Perl
2 perlfaq3		Programming Tools
2 perlfaq4		Data Manipulation
2 perlfaq5		Files and Formats
2 perlfaq6		Regexes
2 perlfaq7		Perl Language Issues
2 perlfaq8		System Interaction
2 perlfaq9		Networking

h Reference Manual

  perlsyn		Perl syntax
  perldata		Perl data structures
  perlop		Perl operators and precedence
  perlsub		Perl subroutines
  perlfunc		Perl built-in functions
2 perlopentut		Perl open() tutorial
2 perlpacktut		Perl pack() and unpack() tutorial
  perlpod		Perl plain old documentation
  perlpodspec		Perl plain old documentation format specification
  perlrun		Perl execution and options
  perldiag		Perl diagnostic messages
  perllexwarn		Perl warnings and their control
  perldebug		Perl debugging
  perlvar		Perl predefined variables
  perlre		Perl regular expressions, the rest of the story
  perlreref		Perl regular expressions quick reference
  perlref		Perl references, the rest of the story
  perlform		Perl formats
  perlobj		Perl objects
  perltie		Perl objects hidden behind simple variables
2 perldbmfilter		Perl DBM filters

  perlipc		Perl interprocess communication
  perlfork		Perl fork() information
  perlnumber		Perl number semantics

  perlthrtut		Perl threads tutorial
2 perlothrtut		Old Perl threads tutorial

  perlport		Perl portability guide
  perllocale		Perl locale support
  perluniintro		Perl Unicode introduction
  perlunicode		Perl Unicode support
  perlebcdic		Considerations for running Perl on EBCDIC platforms

  perlsec		Perl security

  perlmod		Perl modules: how they work
  perlmodlib		Perl modules: how to write and use
  perlmodstyle		Perl modules: how to write modules with style
  perlmodinstall	Perl modules: how to install from CPAN
  perlnewmod		Perl modules: preparing a new module for distribution

  perlutil		utilities packaged with the Perl distribution

  perlcompile		Perl compiler suite intro

  perlfilter		Perl source filters

h Internals and C Language Interface

  perlembed		Perl ways to embed perl in your C or C++ application
  perldebguts		Perl debugging guts and tips
  perlxstut		Perl XS tutorial
  perlxs		Perl XS application programming interface
  perlclib		Internal replacements for standard C library functions
  perlguts		Perl internal functions for those doing extensions
  perlcall		Perl calling conventions from C

  perlapi		Perl API listing (autogenerated)
  perlintern		Perl internal functions (autogenerated)
  perliol		C API for Perl's implementation of IO in Layers
  perlapio		Perl internal IO abstraction interface

  perlhack		Perl hackers guide

h Miscellaneous

  perlbook		Perl book information
  perltodo		Perl things to do

  perldoc		Look up Perl documentation in Pod format

  perlhist		Perl history records
d perldelta		Perl changes since previous version
D perl586delta		Perl changes in version 5.8.6
  perl585delta		Perl changes in version 5.8.5
  perl584delta		Perl changes in version 5.8.4
  perl583delta		Perl changes in version 5.8.3
  perl582delta		Perl changes in version 5.8.2
  perl581delta		Perl changes in version 5.8.1
  perl58delta		Perl changes in version 5.8.0
  perl573delta		Perl changes in version 5.7.3
  perl572delta		Perl changes in version 5.7.2
  perl571delta		Perl changes in version 5.7.1
  perl570delta		Perl changes in version 5.7.0
  perl561delta		Perl changes in version 5.6.1
  perl56delta		Perl changes in version 5.6
  perl5005delta		Perl changes in version 5.005
  perl5004delta		Perl changes in version 5.004

  perlartistic		Perl Artistic License
  perlgpl		GNU General Public License

ho Language-Specific

ro perlcn		Perl for Simplified Chinese (in EUC-CN)
ro perljp		Perl for Japanese (in EUC-JP)
ro perlko		Perl for Korean (in EUC-KR)
ro perltw		Perl for Traditional Chinese (in Big5)

h Platform-Specific

r perlaix		Perl notes for AIX
r perlamiga		Perl notes for AmigaOS
r perlapollo		Perl notes for Apollo DomainOS
r perlbeos		Perl notes for BeOS
r perlbs2000		Perl notes for POSIX-BC BS2000
r perlce		Perl notes for WinCE
r perlcygwin		Perl notes for Cygwin
r perldgux		Perl notes for DG/UX
r perldos		Perl notes for DOS
r perlepoc		Perl notes for EPOC
r perlfreebsd		Perl notes for FreeBSD
r perlhpux		Perl notes for HP-UX
r perlhurd		Perl notes for Hurd
r perlirix		Perl notes for Irix
r perlmachten		Perl notes for Power MachTen
r perlmacos		Perl notes for Mac OS (Classic)
r perlmacosx		Perl notes for Mac OS X
r perlmint		Perl notes for MiNT
r perlmpeix		Perl notes for MPE/iX
r perlnetware		Perl notes for NetWare
r perlos2		Perl notes for OS/2
r perlos390		Perl notes for OS/390
r perlos400		Perl notes for OS/400
r perlplan9		Perl notes for Plan 9
r perlqnx		Perl notes for QNX
r perlsolaris		Perl notes for Solaris
r perltru64		Perl notes for Tru64
r perluts		Perl notes for UTS
r perlvmesa		Perl notes for VM/ESA
r perlvms		Perl notes for VMS
r perlvos		Perl notes for Stratus VOS
r perlwin32		Perl notes for Windows

aoh Auxiliary Documentation

ao a2p
ao c2ph
ao dprofpp
ao h2ph
ao h2xs
ao perlbug
ao perldoc
ao pl2pm
ao pod2html
ao pod2man
ao s2p
ao splain
ao xsubpp
